––––––––––––––
–ooo.–––––––––
–oSoooo–––––––
–ooooooooo––––
––ooooooo–o–––
–––––––o–Too––
–––––––oo–––––
––––––––––––––