––––––––––––––
–ooo.ooo.–––––
–oSoooo......–
–oooooooooooo–
––ooooooooo–––
–––––––ooToo––
–––––––ooo––––
––––––––––––––